6 6 13 15 13 13 13 15 13 13 15 13 13 6 6 6
6 0 6 13 15 13 13 13 13 15 13 13 6 6 6 6
6 0 6 6 13 13 14 12 14 13 13 6 6 6 6 6
6 0 0 0 0 0 0 1 0 0 0 0 0 6 6 6
6 6 0 0 0 0 0 1 0 0 0 0 0 6 6 6
6 6 0 0 0 0 0 1 0 0 0 0 0 6 6 6
6 6 0 0 0 0 0 1 0 0 0 0 0 6 6 6
6 6 0 0 0 0 0 1 0 0 0 0 0 6 6 6
6 6 6 6 0 0 0 1 0 0 0 6 6 6 6 6
6 6 6 6 6 0 0 1 0 0 6 6 6 6 6 6
6 6 6 6 6 6 0 1 0 6 6 6 6 6 6 6
6 6 6 6 6 6 6 1 6 6 6 6 6 6 6 6 