21 21 21 21 21 21 21 21 21 21 21 21 21 21 21 21
21 21 21 21 16 16 16 16 16 16 16 16 21 21 21 21
21 21 21 16 16 16 16 16 16 16 16 16 16 21 21 21
21 21 16 16 16 16 16 16 16 16 16 16 16 16 21 21
21 16 16 16 16 16 16 16 16 16 16 16 16 16 16 21
21 16 16 16 16 16 16 16 16 16 16 16 16 16 16 21
21 16 16 16 16 16 16 16 16 16 16 16 16 16 16 16
21 16 16 16 16 16 16 16 16 16 16 16 16 16 16 21
21 21 16 16 16 16 16 16 16 16 16 16 16 16 21 21
21 21 21 16 16 16 16 16 16 16 16 16 16 21 21 21
21 21 21 21 16 16 16 16 16 16 16 16 21 21 21 21
21 21 21 21 21 21 21 16 21 21 21 21 21 21 21 21