12 12 12 12 12 12 13 16 13 12 12 12 12 12 12 12  
12 12 12 12 12 13 16 16 16 13 12 12 12 12 12 12 
12 12 12 12 13 16 16 16 16 16 13 12 12 12 12 12 
12 12 12 12 13 16 16 16 16 16 13 12 12 12 12 12 
12 12 12 12 13 16 16 16 16 16 13 12 12 12 12 12 
12 12 12 12 13 16 16 16 16 16 13 12 12 12 12 12 
12 12 12 12 13 16 16 16 16 16 13 12 12 12 12 12 
12 12 12 12 13 16 16 16 16 16 13 12 12 12 12 12 
12 12 12 12 13 16 16 16 16 16 13 12 12 12 12 12 
12 12 12 12 13 16 16 16 16 16 13 12 12 12 12 12 
12 12 12 12 12 13 16 16 16 13 12 12 12 12 12 12 
12 12 12 12 12 12 13 16 13 12 12 12 12 12 12 12