6 6 6 6 6 6 6 9 6 6 6 6 6 6 6 6
6 6 6 6 6 6 6 0 6 6 6 6 6 6 6 6
6 0 0 6 6 6 6 0 0 0 6 6 6 6 6 6
6 6 0 6 6 6 6 6 6 0 6 6 6 6 6 6
6 6 0 6 6 6 6 6 0 0 6 6 6 6 6 6
6 6 0 0 6 6 6 6 0 6 6 6 6 6 0 9
6 6 6 0 6 6 0 0 0 6 6 6 0 0 0 6
6 6 6 0 0 0 0 6 6 6 6 6 0 6 6 6
6 6 6 0 6 6 0 6 6 6 6 6 0 6 6 6
6 6 6 0 6 6 0 0 0 0 6 6 0 6 6 6
6 0 0 0 6 6 0 0 0 0 0 0 0 6 6 6
6 6 6 6 6 6 6 9 6 6 6 6 6 6 6 6